................
.../....|.......
..|.....|.......
..|.....|.......
.....@..|.......
........|/......
................
................
